
announcements = аб\'явы аб\'яваў
assign = прызначаць
backtrace = адваротны шлях
backup = рэзервовая копія
Bulk = масавы
capability = здольнасць
Checkbox = Сцяжок
cohort = Кагорта
competencies = кампетэнцыя
completion = Выкананне
condition = умова (плагіна абмежаванняў)
content = змесціва (для агульнага тэрміна), кантэнту (для базы кантэнту)
custom = наладжвальны
custom = уласны
Dashboard = Адукаванне
enrolments = залічэнні
event = падзея
exercise = практыкаванне
External = Вонкавая кагорта
feed (RSS) = стужка
File = Файл (мод)
Final grade = Выніковая адзнака
Folder = Тэчка (мод)
footer = спод
gradebook = журнал адзнак
grouping = групаванняў
Hits = наведванне
home = дом сайта
images = выява
Insight = прадказанне
Label = Цэтлік (мод)
log = лог
manager = кіроўны
Non-editing teacher = Не рэдагавальны настаўнік
notification = паведамленне
Page = Старонка (мод)
pass grade = прахадная адзнака
permission = дазвол
plugins = плагін
rating = ацэнкі
region = вобласць
report = справаздача
restrictions = Абмежаванні
scale = Шкала
shortcuts = хуткія выявы
Starred = Упадабанае
tabs = Укладкі
target = мэта
Teacher = Настаўнік
tick box = галачка
Timeline block = блок Часовая шкала
Upcoming = будучы
Username = логін
Warnings = папярэджанні
workshop = майстэрня