Advanced = прасунуты
Allocated Marker = Разьмеркаваная пазнака
announcements = аб\'явы аб\'яваў
Answer = адказ (question)
appearance = выгляд
area = вобласьць
assessment = ацэньванне (workshop)
assign = заданьне (калі актыўнасьць)
assign = прызначаць
assignment = заданьне
assignment submission = заданьне пададзенае на адзнаку (ацэньваньне)
attached = прымацаванага
attachments = укладаньні
attempt = спроба
backtrace = адваротны шлях
backup = рэзервовая копія
badges = дасягненьне
blog = блог
Bonus points = Бонусныя балы (grade)
book = кніга
box = скрынка
Bulk = масавы
Cache = кэш
Calculated = вылічвальнае (пытаньне)
calculation = разьлік
capability = здольнасьць
chapter = глава (кнігі)
Checkbox = Сьцяжок
choice = выбар
clipboard = буфер абмену
cloze question = закрытае пытаньне
Cognitive depth = глыбіні пазнаваньня
cognitive engagement = пазнавальнага ўцягненьня
cohort = Кагорта
competencies = кампетэнцыя
completion = Выкананне
concept = тэрмін (glossary, слоўнік)
condition = умова (плагіна абмежаванняў)
contact = кантакт
content = зьмесьціва (для агульнага тэрміна), кантэнту (для базы кантэнту і h5p)
conversation = гутарка
custom = наладжвальны
custom = уласны
custom field = наладжанае поле
Dashboard = Прыладавая Прыладавую
Database (data.php) = База дадзеных
default = стандартны
Definition = Азначэньне (glossary, слоўнік)
digest = Дайджэст
discussion = абмеркаваньне
drag and drop = перасоўваньне
drawer = малявальнік
drop-down menu = выпадное меню
email = Імэйл
emoticon = эматыкон
enrolments = залічэньні
entry = запіс (glossary, слоўнік)
essay = эсэ (пытаньне)
event = падзея
exception = выключэньне
exercise = практыкаваньне
External = Вонкавая кагорта
External tool = Вонкавы сродак
extra credit = дадатковая адзнака (extra credit)
fail grades = няўдалыя адзнакі
favourite = Упадабанае
features = функцыі
feed (RSS) = стужка
feedback = водгук
File = Файл (мод)
file area = вобласьць файлаў
file picker = выбарнік файлаў
files manager = кіраўнік файлаў
filter = фільтар
Final grade = Выніковая адзнака
Folder = Тэчка (мод)
footer = ніжні калонтытул
footer = спод
General feedback = агульны водгук (тэст)
glossary = слоўнік
grade item = прадмет адзнакі
grade letter = Літара-адзнака
gradebook = журнал адзнак
grader = адзначнік (grade)
grouping = групаваньняў
hash = хэш
Hits = наведваньне
home = дом сайта
icons = выявы
images = выява
Insight = прадказаньне
insights = асьвятленьні
jobs = працы (крон)
jump = скок (занятак)
label = пазнака (Track)
Label = Цэтлік (мод)
Latest announcements = Апошнія аб\'явы
launcher = запускальнік
layout = макет
lesson = занятак
locked = заблакавана
log = лог
manager = кіроўны
mark = пазнака
marker = паказьнік
markers = правяральнікі (заданьне)
marking workflow = правяраны працоўны струмень
matching = адпаведнасьць (пытаньне)
Mean (average grade) = прыблізная сярэдняя
message = паведамленьне
missing word = адсутнае слова (пытаньне)
Moodle-auto format = аўтафарматаваньне Moodle
multi choice = множны выбар (пытаньне)
Multichoice = множны выбар (пытаньне)
multilang = шматмоўе
Mute = Заглушыць 
my moodle = прыладавай
Non-editing teacher = Настаўнік-нерэдактар
note = нататка
notification = абвестка, абвяшчэньне
Numerical = лікавае (пытаньне)
optional = Дадаткова
outcome = вынік (grade)
outcomes = вынікі (grade)
overall feedback = выніковы водгук (тэст)
overall grade = агульная адзнака
overridden (grade) = перавызначаная
Page = Старонка (мод)
pass grade = прахадная адзнака
peer assessment = калегійнае ацэньваньне
Pending = у чарзе
Permalink = сталая спасылка
permission = дазвол
picker = выбарнік
placeholders = запаўняльнік
plagiarism = плагіят
plugins = плагін
points = балы (grade)
portfolio = партфоліа
post = пост, паста, пасты, посьціць, запошчаны (форум і блог)
Preset = прадусталёўка
Privacy = Прыватнасьць
processing = апрацоўка
question = пытаньне
quiz = тэст
radio buttons = перамыкальнік
rank (grade) = Рэйтынг
rating = рэйтынг рэйтынгаваць адрэйтынгаваць
Raw grade = сырая адзнака
region = вобласьць
Release grades = вызваленьне адзнак
reminders = напаміны
reply = адказ (форум)
report = справаздача
response = водкліч (заданьне, водгук, тэст), водгук (астатняя)
restrictions = Абмежаваньні
RSS feed = RSS-стужка
scale = шкала
scheduled task = запланаванае заданьне
score = бал (занятак)
section = падзел (курса)
self enrolment = самастойнага залічэньня
separate groups = адасобленымі групамі
separate groups = адасобленыя групы
separator = падзельнік
share = апублічыць
sharing = супольнага выкарыстаньня (question)
Short answer = кароткі адказ (пытаньне)
shortcuts = хуткія выявы
Slot = слот
Starred = Упадабанае
Submissions = адпраўленьне
submit = адправіць
subscribe = падпіска, падпісвацца
summary = ??? кароткі агляд ???
survey = апытанка
Suspended = Заблакаваны
sync = сінхр
tabs = Укладкі
tag = тэг
target = мэта
task = заданьне (scheduled)
Teacher = Настаўнік
text areas = тэкставая вобласьць
Thumbnail = Мініяцюра
tick box = галачка
Timeline block = блок Часовая шкала
title = назва 
toggles = перамыкальнікі
total grade = агульная адзнака
Track = сьцежка
trie = спроба (question)
True/false = праўда/няпраўда (пытаньне)
UI = КІ
unlocked = разблакавана
Upcoming = будучы
Username = логін
value grade type = адзнака тыпу значэньне
Verbose scales = Слоўны шкалы
visible groups = бачныя групы
Warnings = папярэджаньні
wildcard = падстаўны знак, падстанова
workflow state = статус працоўнага струменя
workshop = майстэрня